----------
----------
----------
------GO--
--------B-
-----R----
---G-----R
----O----P
----------
--------PB